< 18  2 up right right down down up up left left down
< 19  2 right down down left left up right up
<  1 10 right down up left
####################X#
#P    #####          #
#     #####          #
#                    #
#                    #
#                    #
#       ###          #
#       ###          #
#       #####        #
#                 ####
#                    #
#G                #  #
######      #######  #
     #       #EB     #
     #       #H      #
     #################
