<  X Y
######################
#                    #
#                    #
#                    #
#                    #
#                    #
#                    #
#                    #
#                    #
#                    #
#                    #
#                    #
######               #
     #               #
     #               #
     #################
