< 19 1 right down down left left right right up up left left right
<  4 3 down down down down left up up up up right
<  1 9 right right right down left left left up
######################
#P                   #
#################### #
#G   #               #
#    #               #
#    #               #
#    #               #
#                    #
#### #               #
#    #               #
#    #               #
#E  G### ### #########
######    #          #
     #    #       #B #
     #H   #       #  #
     ##############X##
