<  2 11 right right right left left left
< 19 10 down right left up
< 10  1 left down up right right down up left
######################
#P#                  #
# #       #          #
# #       #          #
# #       #          #
# #       #          #
# #       #          #
# #       #          #
# #       #          #
# #       # ##########
# ####   ##         E#
#        G#H#        #
#############        #
     #B    G#        #
     X              G#
     #################
